..........................
..........................
..........................
..........................
.........@@@@@@@..........
....@.....................
....@..............@......
....@..............@......
....@..............@......
....@..............@......
....@..............@......
..........................
..........................
..........................
..........................
..........................
..........................
..........................
..........................
..........................
..........................
..........................
..........................
..##..##...####...##..##..
...........#..#...........
...........#..#...........