..........................
..........................
...#....#...........#####.
...#....#...........##..#.
...#....#..%%%%..##.....#
.#......#..%%%%..##.....#
##......#.%%%%%%%%##.....#
##......##%%%%%%%%##.....#
##.....###%%@@@@%%###...##
##.....###%%@@@@%%###...##
.#....##............######
.#######............######
....####@@@@##@@@@#####...
....####@@@@##@@@@#####...
....####@@..##..@@#####...
....####@@..##..@@#####...
....###################...
....###################...
..%%######@@@@########..##
..%%......@@@@..........##
..%%%%%%%%%%%%%%%%%%%%%%##
..%%%%%%%%%%%%%%%%%%%%%%##
....%%%%%%......%%%%%%%%..
....%%%%%%.####.%%%%%%%%..
......#....#..#.....#.....
......#....#..#.....#.....