........##................
........##................
........##......@@@@@@....
@@......##..........@@....
@@...........#............
@@...........#............
##...####....#....~~....~~
##...####...##....~~....~~
##......#.........~~......
..................~~......
........~~~...~~~~~~....##
........~~~...~~~~~~....##
####....~~....###.........
####....~~....###.........
........~~...........@....
........~~...........@....
~~~~~...~~...@...#...@....
~~~~~...~~...@...#...@....
.....................@####
......####...........@####
........##########........
........##......####......
####..............####....
####.......####.....##....
##.........#..#...........
...........#..#...........