...........#..#.%%%%......
...........#..#.%%%%......
..#.....#...........#.....
..#.....#........#%.#.....
..#.....#...##...#%%#...%%
..#.....#...##...#%%#...%%
..##....#...%%..##%%....%%
..##....#...%%..##%%....%%
.......#%%..##..##%...%%%%
.......#....##....%...%%%%
##........%%##%%.....#####
###.......%%##%%.....#####
.........#%%%%%%%.........
.........#%%%%%%%.........
@@####..##%%%%%%...#####@@
@@####....%%%%%%...#####@@
@@@@@@......%%......%%%%@@
........##..%%..##........
..##....##......##........
..##....##......##........
..###.....%%..%%.....###%%
..###................###%%
....##..............%%%%%%
...........####.....%%%%%%
...........#..#.......%%%%
....##.....#..#.....##%%%%